15 15
64 640
832 704
3
2 2 2 2 2 2 2 2 2 2 2 2 2 2 2
2 0 0 0 0 0 0 0 0 0 0 0 0 0 2
2 0 0 1 1 1 1 1 1 1 1 1 0 0 2
2 0 0 1 1 1 1 1 1 1 1 1 0 0 2
2 0 0 2 2 2 2 2 2 2 2 2 0 0 2
2 0 0 2 1 1 1 1 1 1 1 2 0 0 2
2 0 0 0 1 1 1 1 1 1 1 2 0 0 2
2 0 0 0 1 1 1 1 1 1 1 2 0 0 2
2 0 0 2 1 1 1 1 1 1 1 2 0 0 2
2 0 0 1 1 1 1 1 1 2 2 2 0 0 2
3 0 0 0 0 0 0 0 0 0 0 0 0 0 2
2 0 0 0 0 0 0 0 0 0 0 0 0 0 2
2 0 0 0 0 0 0 0 0 0 0 0 0 0 2
2 0 0 0 0 0 0 0 0 0 0 0 0 0 2
2 2 2 2 2 2 2 2 2 2 2 2 2 2 2