25 20
256 384
1536 448
1
26 487 24 25 25 25 25 25 25 48 49 74 74 74 74 74 97 48 48 48 48 48 48 48 48
49 487 47 48 0 0 0 0 48 48 49 74 97 97 97 97 48 119 120 121 48 48 48 48 48
49 487 47 0 0 0 0 0 0 48 49 27 48 48 48 48 48 142 143 144 48 48 48 48 48
49 487 47 0 0 0 0 0 48 48 49 27 48 48 48 48 48 165 123 167 48 48 48 48 48
49 487 47 0 0 0 0 0 0 48 49 27 48 48 48 48 48 48 188 48 48 48 48 48 48
49 487 47 0 0 0 48 48 48 48 49 27 48 48 48 48 48 48 188 48 48 48 48 48 48
213 57 211 166 166 166 190 190 190 213 72 27 48 48 48 48 48 48 188 48 48 48 48 48 48
72 487 70 104 105 71 71 48 73 74 74 74 48 48 48 48 48 48 305 190 190 190 190 190 213
74 392 51 150 151 97 99 74 97 51 51 98 48 48 48 48 48 48 188 48 48 48 48 48 48
97 438 71 58 59 71 71 73 48 48 48 48 48 48 48 48 48 48 188 48 48 48 48 48 48
49 487 96 150 151 97 97 315 48 119 120 121 48 48 48 48 48 48 188 48 48 48 48 48 48
49 499 211 190 190 190 190 190 190 169 143 123 190 190 307 190 190 190 331 190 190 308 213 48 48
49 499 47 48 48 48 48 48 48 165 166 167 48 48 188 48 48 48 48 48 48 188 48 48 48
118 487 518 518 579 238 238 121 48 48 48 48 48 48 188 48 48 48 48 48 48 188 48 48 48
393 487 487 487 535 169 169 144 48 48 48 48 48 48 188 48 48 48 48 48 48 188 48 48 48
487 487 499 487 500 511 511 577 48 48 48 48 48 48 188 48 48 48 48 48 48 188 48 48 48
487 499 499 489 487 487 487 536 48 48 119 120 121 48 188 48 48 48 48 48 119 123 121 48 48
489 499 499 489 489 487 487 536 48 48 142 143 123 190 195 48 48 48 48 48 142 143 144 48 48
487 489 489 489 487 487 487 536 48 48 165 166 167 48 48 48 48 48 48 48 165 166 167 48 48
487 487 489 487 487 487 487 536 48 48 48 48 48 48 48 48 48 48 48 48 48 48 48 48 48

0 0 0 0 0 0 0 0 0 0 0 0 0 0 0 0 0 0 0 0 0 0 0 0 0
0 0 0 62 86 86 86 86 65 0 0 0 0 0 0 0 0 0 0 0 0 0 0 0 0
0 0 0 85 86 39 64 64 41 0 0 0 0 0 0 0 0 0 0 0 0 0 0 0 0
0 0 296 108 110 111 248 271 249 298 0 0 0 0 0 0 0 0 0 0 0 0 0 0 0
0 0 296 248 178 249 269 224 269 298 0 0 0 0 0 0 0 0 0 0 0 0 0 0 0
0 0 296 156 269 203 276 274 274 321 0 0 0 0 0 0 0 0 0 0 0 0 0 0 0
0 0 319 274 274 274 321 0 0 0 0 0 0 0 0 0 0 0 0 0 0 0 0 0 0
0 0 0 0 0 0 0 0 0 0 0 0 0 0 0 0 0 0 0 0 0 0 0 0 0
0 0 0 0 0 0 0 0 0 0 0 0 0 0 0 0 0 0 0 0 0 0 0 0 0
0 0 0 0 0 0 0 0 0 0 0 0 0 0 0 0 0 0 0 0 0 0 0 0 0
0 0 0 0 0 0 0 0 0 0 0 0 0 0 0 0 0 0 0 0 0 0 0 0 0
0 0 0 0 0 0 0 0 0 0 0 0 0 0 0 0 0 0 0 0 0 0 0 0 0
0 0 0 0 0 0 0 0 0 0 0 0 0 0 0 0 0 0 0 0 0 0 0 0 0
0 0 0 0 0 0 0 0 0 0 0 0 0 0 0 0 0 0 0 0 0 0 0 0 0
0 0 0 0 0 0 0 0 0 0 0 0 0 0 0 0 0 0 0 0 0 0 0 0 0
0 0 0 0 0 0 0 0 0 0 0 0 0 0 0 0 0 0 0 0 0 0 0 0 0
0 0 0 0 0 0 0 0 0 0 0 0 0 0 0 0 0 0 0 0 0 0 0 0 0
0 0 0 0 0 0 0 0 0 0 0 0 0 0 0 0 0 0 0 0 0 0 0 0 0
0 0 0 0 0 0 0 0 0 0 0 0 0 0 0 0 0 0 0 0 0 0 0 0 0
0 0 0 0 0 0 0 0 0 0 0 0 0 0 0 0 0 0 0 0 0 0 0 0 0

0 0 0 0 0 0 0 0 277 278 0 0 0 0 0 0 0 255 0 0 0 0 0 0 0
0 0 139 0 0 0 0 0 300 301 0 0 0 0 0 0 255 0 120 120 120 121 254 254 0
0 0 0 0 0 0 0 279 280 258 323 0 255 255 255 255 255 0 0 143 143 144 254 254 0
0 0 232 0 0 0 0 302 303 258 323 0 255 0 0 0 0 0 0 166 166 167 0 0 0
0 0 186 0 0 0 0 277 278 258 323 0 255 0 0 0 0 0 0 0 0 141 141 0 0
0 0 232 0 0 0 232 300 301 232 0 0 255 257 186 186 0 0 0 0 0 141 141 0 0
0 0 0 0 0 0 0 0 0 0 162 0 255 257 257 257 0 0 0 100 0 0 0 250 251
0 0 164 0 0 186 186 0 0 0 0 0 255 139 257 257 186 0 0 0 0 0 0 0 0
0 0 0 0 0 0 0 0 0 0 0 103 233 233 139 186 139 0 0 0 0 0 0 250 251
0 0 187 0 0 187 187 0 257 304 258 257 233 233 0 0 0 0 0 0 141 0 0 0 0
0 0 0 0 0 0 0 0 258 0 0 0 0 0 0 0 0 100 0 0 0 0 100 0 0
0 0 0 0 0 0 0 0 0 0 0 0 0 0 0 0 0 0 0 0 0 0 0 323 0
139 0 0 0 0 0 0 0 0 0 0 0 0 0 0 100 0 0 0 0 0 0 0 0 0
256 0 0 0 0 0 0 0 0 0 0 0 0 0 0 0 233 233 233 233 0 0 0 256 0
0 0 0 0 0 0 0 0 0 0 255 255 255 0 0 0 233 257 257 233 0 0 0 256 256
0 0 0 0 0 0 0 0 119 120 120 120 121 0 0 0 233 257 257 233 0 0 0 0 0
0 0 0 0 0 0 0 0 142 143 143 143 144 0 0 0 233 233 233 233 0 0 120 120 121
0 0 0 0 0 0 0 0 142 143 143 0 0 0 0 323 0 0 0 0 0 0 143 143 144
0 0 0 0 0 0 0 0 142 143 143 143 144 0 323 323 0 0 0 0 142 143 143 143 144
0 0 0 0 0 0 0 0 165 166 166 166 167 0 0 0 0 0 0 0 165 166 166 166 167
