15 15
64 64
832 512
1
2 2 2 2 2 2 2 2 2 2 2 2 2 2 2
2 0 00 0 0 0 0 0 0 0 0 0 0 0 2
2 0 0 01 1 1 1 1 1 1 1 1 0 0 2
2 0 0 1 1 1 1 1 1 1 1 1 0 0 2
2 0 0 2 2 2 2 2 2 2 2 2 0 0 2
2 0 0 1 1 1 1 1 1 1 1 1 0 0 2
2 1 1 1 1 1 1 1 1 1 1 1 1 1 2
2 1 1 1 1 1 1 1 1 1 1 1 1 1 2
2 0 0 0 0 0 0 0 0 0 0 0 0 0 3
2 0 0 2 2 2 0 0 0 2 2 2 0 0 2
2 0 0 2 1 2 0 0 0 2 1 2 0 0 2
2 0 0 2 1 1 1 1 1 1 1 2 0 0 2
2 0 0 2 1 1 1 1 1 1 1 2 0 0 2
2 0 0 2 1 1 1 1 1 1 1 2 0 0 2
2 2 2 2 2 2 2 2 2 2 2 2 2 2 2