25 20
192 384
64 64
1
4
026 487 024 025 025 025 025 025 025 048 049 074 074 074 074 074 097 048 048 048 048 048 048 048 048
049 487 047 048 000 000 000 000 048 048 049 074 097 097 097 097 048 119 120 121 048 048 048 048 048
049 487 047 000 000 000 000 000 000 048 049 027 048 048 048 048 048 142 143 144 048 048 048 048 048
049 487 047 000 000 000 000 000 048 048 049 027 048 048 048 048 048 165 123 167 048 048 048 048 048
049 487 047 000 000 000 000 000 000 048 049 027 048 048 048 048 048 048 188 048 048 048 048 048 048
049 487 047 000 000 000 048 048 048 048 049 027 048 048 048 048 048 048 188 048 048 048 048 048 048
213 057 211 166 166 166 190 190 190 213 072 027 048 048 048 048 048 048 188 048 048 048 048 048 048
072 487 070 104 105 071 071 048 073 074 074 074 048 048 048 048 048 048 305 190 190 190 190 190 213
074 392 051 150 151 097 099 074 097 051 051 098 048 048 048 048 048 048 188 048 048 048 048 048 048
097 438 071 058 059 071 071 073 048 048 048 048 048 048 048 048 048 048 188 048 048 048 048 048 048
049 487 096 150 151 097 097 315 048 119 120 121 048 048 048 048 048 048 188 048 048 048 048 048 048
049 499 211 190 190 190 190 190 190 169 143 123 190 190 307 190 190 190 331 190 190 308 213 048 048
049 499 047 048 048 048 048 048 048 165 166 167 048 048 188 048 048 048 048 048 048 188 048 048 048
118 487 518 518 579 238 238 121 048 048 048 048 048 048 188 048 048 048 048 048 048 188 048 048 048
393 487 487 487 535 169 169 144 048 048 048 048 048 048 188 048 048 048 048 048 048 188 048 048 048
487 487 499 487 500 511 511 577 048 048 048 048 048 048 188 048 048 048 048 048 048 188 048 048 048
487 499 499 489 487 487 487 536 048 048 119 120 121 048 188 048 048 048 048 048 119 123 121 048 048
489 499 499 489 489 487 487 536 048 048 142 143 123 190 195 048 048 048 048 048 142 143 144 048 048
487 489 489 489 487 487 487 536 048 048 165 166 167 048 048 048 048 048 048 048 165 166 167 048 048
487 487 489 487 487 487 487 536 048 048 048 048 048 048 048 048 048 048 048 048 048 048 048 048 048

000 000 000 000 000 000 000 000 000 000 000 000 000 000 000 000 000 000 000 000 000 000 000 000 000
000 000 000 062 086 086 086 086 065 000 000 000 000 000 000 000 000 000 000 000 000 000 000 000 000
000 000 000 085 086 039 064 064 041 000 000 000 000 000 000 000 000 000 000 000 000 000 000 000 000
000 000 296 108 110 111 248 271 249 298 000 000 000 000 000 000 000 000 000 000 000 000 000 000 000
000 000 296 248 178 249 269 224 269 298 000 000 000 000 000 000 000 000 000 000 000 000 000 000 000
000 000 296 156 269 203 276 274 274 321 000 000 000 000 000 000 000 000 000 000 000 000 000 000 000
000 000 319 274 274 274 321 000 000 000 000 000 000 000 000 000 000 000 000 000 000 000 000 000 000
000 000 000 000 000 000 000 000 000 000 000 000 000 000 000 000 000 000 000 000 000 000 000 000 000
000 000 000 000 000 000 000 000 000 000 000 000 000 000 000 000 000 000 000 000 000 000 000 000 000
000 000 000 000 000 000 000 000 000 000 000 000 000 000 000 000 000 000 000 000 000 000 000 000 000
000 000 000 000 000 000 000 000 000 000 000 000 000 000 000 000 000 000 000 000 000 000 000 000 000
000 000 000 000 000 000 000 000 000 000 000 000 000 000 000 000 000 000 000 000 000 000 000 000 000
000 000 000 000 000 000 000 000 000 000 000 000 000 000 000 000 000 000 000 000 000 000 000 000 000
000 000 000 000 000 000 000 000 000 000 000 000 000 000 000 000 000 000 000 000 000 000 000 000 000
000 000 000 000 000 000 000 000 000 000 000 000 000 000 000 000 000 000 000 000 000 000 000 000 000
000 000 000 000 000 000 000 000 000 000 000 000 000 000 000 000 000 000 000 000 000 000 000 000 000
000 000 000 000 000 000 000 000 000 000 000 000 000 000 000 000 000 000 000 000 000 000 000 000 000
000 000 000 000 000 000 000 000 000 000 000 000 000 000 000 000 000 000 000 000 000 000 000 000 000
000 000 000 000 000 000 000 000 000 000 000 000 000 000 000 000 000 000 000 000 000 000 000 000 000
000 000 000 000 000 000 000 000 000 000 000 000 000 000 000 000 000 000 000 000 000 000 000 000 000

000 000 000 000 000 000 000 000 277 278 000 000 000 000 000 000 000 255 000 000 000 000 000 000 000
000 000 139 000 000 000 000 000 300 301 000 000 000 000 000 000 255 000 120 120 120 121 254 254 000
000 000 139 000 000 000 000 279 280 258 323 000 255 255 255 255 255 000 000 143 143 144 254 254 000
000 000 232 000 000 000 000 302 303 258 323 000 255 000 000 000 000 000 000 166 166 167 000 000 000
000 000 186 000 000 000 000 277 278 258 323 000 255 000 000 000 000 000 000 000 000 141 141 000 000
000 000 232 000 000 000 232 300 301 232 000 000 255 257 186 186 000 000 000 000 000 141 141 000 000
000 000 000 000 000 000 000 000 000 000 162 000 255 257 257 257 000 000 000 100 000 000 000 250 251
000 000 164 000 000 186 186 000 000 000 000 000 255 139 257 257 186 000 000 000 000 000 000 000 999
000 000 000 000 000 000 000 000 000 000 000 103 233 233 139 186 139 000 000 000 000 000 000 250 251
000 000 187 000 000 187 187 000 257 304 258 257 233 233 000 000 000 000 000 000 141 000 000 000 000
000 000 000 000 000 000 000 000 258 000 000 000 000 000 000 000 000 100 000 000 000 000 100 000 000
000 000 000 000 000 000 000 000 000 000 000 000 000 000 000 000 000 000 000 000 000 000 000 323 000
139 000 000 000 000 000 000 000 000 000 000 000 000 000 000 100 000 000 000 000 000 000 000 000 000
256 000 000 000 000 000 000 000 000 000 000 000 000 000 000 000 233 233 233 233 000 000 000 256 000
000 000 000 000 000 000 000 000 000 000 255 255 255 000 000 000 233 257 257 233 000 000 000 256 256
000 000 000 000 000 000 000 000 119 120 120 120 121 000 000 000 233 257 257 233 000 000 000 000 000
000 000 000 000 000 000 000 000 142 143 143 143 144 000 000 000 233 233 233 233 000 000 120 120 121
000 000 000 000 000 000 000 000 142 143 143 000 000 000 000 323 000 000 000 000 000 000 143 143 144
000 000 000 000 000 000 000 000 142 143 143 143 144 000 323 323 000 000 000 000 142 143 143 143 144
000 000 000 000 000 000 000 000 165 166 166 166 167 000 000 000 000 000 000 000 165 166 166 166 167

000 998 000 998 000 000 000 000 000 000 000 998 998 998 998 998 998 000 000 000 000 000 000 000 000
000 998 998 998 998 998 998 998 998 998 000 998 998 998 998 998 000 000 000 000 000 000 998 998 000
000 998 998 998 998 998 998 998 998 998 998 998 000 000 000 000 000 000 000 000 000 000 998 998 000
000 998 000 998 998 998 998 998 998 998 998 998 000 000 000 000 000 000 000 000 000 000 000 000 000
000 998 000 998 998 998 998 998 998 998 998 998 000 000 000 000 000 000 000 000 000 998 998 000 000
000 998 000 998 998 998 000 998 998 000 000 998 000 998 000 000 000 000 000 000 000 998 998 000 000
000 000 000 000 000 000 000 000 000 000 998 998 000 998 998 998 000 000 000 998 000 000 000 998 998
000 998 000 998 000 000 000 000 998 998 998 998 000 998 998 998 000 000 000 000 000 000 000 000 000
998 998 998 998 000 998 998 998 998 998 998 998 000 000 998 000 998 000 000 000 000 000 000 998 998
998 998 998 998 000 000 000 998 998 000 000 998 000 000 000 000 000 000 000 000 998 000 000 000 000
000 998 000 998 000 998 998 998 000 000 000 000 000 000 000 000 000 998 000 000 000 000 998 000 000
000 998 000 998 000 000 000 000 000 000 000 000 000 000 000 000 000 000 000 000 000 000 000 998 000
998 998 998 998 000 000 000 000 000 000 000 000 000 000 000 998 000 000 000 000 000 000 000 000 000
256 998 000 998 000 000 000 000 000 000 000 000 000 000 000 000 000 000 000 000 000 000 000 000 000
998 998 998 998 998 998 000 000 000 000 000 000 000 000 000 000 000 998 998 000 000 000 000 000 000
998 998 998 998 998 998 000 000 000 000 000 000 000 000 000 000 000 998 998 000 000 000 000 000 000
998 998 998 998 998 998 998 998 998 000 000 000 000 000 000 000 000 000 000 000 000 000 000 000 000
998 998 998 998 998 998 998 998 998 000 000 000 000 000 000 998 000 000 000 000 000 000 000 000 000
998 998 998 998 998 998 998 998 998 000 000 000 000 000 998 998 000 000 000 000 000 000 000 000 000
998 998 998 998 998 998 998 998 998 000 000 000 000 000 000 000 000 000 000 000 000 000 000 000 000

