15 15
64 256
832 704
2
2 2 2 2 2 2 2 2 2 2 2 2 2 2 2
2 0 0 0 0 0 0 0 0 0 0 0 0 0 2
2 0 0 1 1 1 1 1 1 1 1 1 0 0 2
2 0 0 1 1 1 1 1 1 1 1 1 0 0 2
3 0 0 2 2 2 2 2 2 2 2 2 0 0 2
2 0 0 2 1 1 1 1 1 1 1 2 0 0 2
2 0 0 0 1 1 1 1 1 1 1 2 0 0 2
2 0 0 0 1 1 1 1 1 1 1 2 0 0 2
2 0 0 2 1 1 1 1 1 1 1 2 0 0 2
2 0 0 2 2 2 2 2 2 2 2 2 0 0 2
2 0 0 0 0 0 0 0 0 0 0 0 0 0 2
2 0 0 0 0 0 0 0 0 0 0 0 0 0 3
2 0 0 0 0 0 0 0 0 0 0 0 0 0 2
2 0 0 0 0 0 0 0 0 0 0 0 0 0 2
2 2 2 2 2 2 2 2 2 2 2 2 2 2 2